########################################
#.#.......................#............#
#.#.......................#............#
#.######################################
#--------|---------##---------|--------#
#-#######-########-##-########-#######-#
#-#.....#-#......#-##-#......#-#.....#+#
#-#######-########-##-########-#######-#
#|-------|--|-----|--|-----|--|-------|#
#-#######-##-##############-##-#######-#
#--------|##-------##-------##|--------#
#########-########-##-########-#########
#.......#-########-##-########-#.......#
#.......#-##------|--|------##-#.......#
#.......#-##-##############-##-#.......#
#########-##-#............#-##-#########
#--------|--|#............#|--|--------#
#########-##-#............#-##-#########
#.......#-##-##############-##-#.......#
#.......#-##--------*-------##-#.......#
#########-##-##############-##-#########
#--------|--|------##------|--|--------#
#-#######-########-##-########-#######-#
#-#######-########-##-########-#######-#
#-#######|--|-----|--|-----|--|#######-#
#-#######-##-##############-##-#######-#
#|--------##-------###------##--------|#
#-################-###-###############-#
#-------*---------|---|---------+------#
########################################

