########################################
#-------------------------#............#
#-#########################............#
#-#-####################################
#-#-#--------*------|--------+---------#
#-#-#-##############-#################-#
#|-|-|--------------|----------------#-#
#-#-##################################-#
#-#-#################-----------------|#
#-#-#-----------------################-#
#-#|-|#################---------------|#
#-#-#-########----|---#-##############-#
#-#-#----------###-##-#---------------|#
#-#-##############-##-################-#
#|-|--------------|##|----------------|#
#-################-##-################-#
#---|-------------|--|--------------|--#
####-###############################-###
#---|--------------*----------------|###
####-###############################-###
#---|-------------------------------|--#
#-#-#-################################-#
#-#-#-###---------###----|-----------#-#
#-#-#----|#######-###-###-############-#
#-#-#####---------###-###|------------|#
#-#|----#-#######-###-###-############-#
#-#-###|#|--------###-###|-----------#-#
#-#-###-#-#######-###-###-##########-#-#
#--|----#---------###----|----------|--#
########################################

