########################################
#----------|--------------#............#
#-#########-###############............#
#|---------|-------#####################
#-################-######|----|-*------#
#|---|------------|--|----####-#######-#
#-###-########################-#######-#
#-###-########################-#######-#
#|---|-------#------------#---|-------|#
#-##########|--##########--|##########-#
#|-------#---##############----#------|#
#-######|--#####.#############--|#####-#
#|-----|-#######################-|----|#
#-#####-#########################-####-#
#|-----|--#######################-----|#
#-#######|----########################-#
#|-------|###|-+-##################---|#
#-#######|----########################-#
#|-----|--#######################-----|#
#-#####-#########################-####-#
#|-----|-#######################-|----|#
#-######|--###################--|#####-#
#|-------#---##############----#------|#
#-##########|--##########--|##########-#
#|------|----#-|--|--|--|-#----|------|#
#-######-######-##-##-##-######-######-#
#|------|------|--|--|--|------|------|#
#-################-##-################-#
#-------+---------|--|--------*--------#
########################################

